tiles = {
	{0,0,0,0,0,0,0,0,0,0,0,0,0,0,0,0,0,0,0,0,0,0,0,0,0,0,0,0,},
	{0,15,20,20,20,20,20,20,20,20,20,20,20,20,20,20,20,20,20,20,20,20,20,20,20,20,16,0,},
	{0,19,10,10,10,10,10,10,10,10,10,10,10,10,10,10,10,10,10,10,10,10,10,10,10,10,19,0,},
	{0,19,1,1,1,1,1,1,1,1,1,1,1,1,1,1,1,1,1,1,1,1,1,1,1,1,19,0,},
	{0,19,1,1,1,1,1,1,1,1,1,1,1,1,1,1,1,1,1,1,2,1,1,9,1,1,19,0,},
	{0,19,1,1,1,1,1,1,1,1,1,1,1,1,1,1,1,1,1,1,2,1,1,1,1,1,19,0,},
	{0,19,1,1,1,1,1,1,1,13,1,1,15,20,20,16,1,1,1,1,15,16,1,1,1,1,19,0,},
	{0,19,1,1,1,1,1,1,1,19,1,1,19,10,10,19,1,1,1,1,19,19,1,1,1,1,19,0,},
	{0,19,1,1,15,20,20,20,20,18,1,1,19,0,0,19,1,1,1,1,19,19,1,1,1,1,19,0,},
	{0,19,1,1,19,10,10,10,10,10,1,1,19,0,0,19,1,1,1,1,19,19,1,2,1,1,19,0,},
	{0,19,1,1,14,1,1,1,9,1,1,1,19,0,0,19,1,1,1,2,19,19,1,1,1,1,19,0,},
	{0,19,1,1,10,1,1,1,9,1,1,1,19,0,0,19,1,1,1,1,19,19,1,1,1,1,19,0,},
	{0,19,1,1,1,1,1,1,15,16,1,1,19,0,0,19,9,1,1,1,19,19,1,1,1,1,19,0,},
	{0,19,1,2,1,1,1,1,17,18,1,1,19,0,0,19,1,1,1,1,19,19,1,1,1,1,19,0,},
	{0,19,1,1,1,1,1,1,10,10,1,1,19,0,0,19,1,1,1,1,17,18,1,1,1,1,19,0,},
	{0,19,1,1,1,1,1,1,1,1,1,1,19,0,0,19,1,1,1,9,10,10,1,1,1,1,19,0,},
	{0,19,1,1,2,1,1,1,1,1,1,1,19,0,0,19,1,1,1,9,9,1,1,1,1,1,19,0,},
	{0,19,1,1,1,1,1,1,1,1,1,1,19,0,0,19,1,1,1,1,1,1,1,1,1,2,19,0,},
	{0,17,20,20,20,16,1,1,15,20,20,20,18,0,0,17,20,20,20,16,1,1,15,20,20,20,18,0,},
	{0,10,10,10,10,19,1,1,19,10,10,10,10,0,0,10,10,10,10,19,1,9,19,10,10,10,10,0,},
	{0,0,0,0,0,19,1,1,19,0,0,0,0,0,0,0,0,0,0,19,1,1,19,0,0,0,0,0,},
},ENDTILES.

colls = {
	{x=85,y=94,w=11,h=514},
	{x=96,y=609,w=127,h=8},
	{x=216,y=621,w=7,h=82},
	{x=289,y=619,w=7,h=85},
	{x=288,y=608,w=129,h=9},
	{x=415,y=224,w=12,h=384},
	{x=433,y=225,w=110,h=9},
	{x=533,y=242,w=11,h=363},
	{x=544,y=609,w=128,h=8},
	{x=665,y=620,w=7,h=83},
	{x=97,y=83,w=767,h=12},
	{x=864,y=99,w=6,h=510},
	{x=735,y=608,w=126,h=10},
	{x=736,y=624,w=7,h=79},
	{x=288,y=417,w=63,h=62},
	{x=159,y=287,w=33,h=98},
	{x=196,y=287,w=122,h=33},
	{x=320,y=223,w=32,h=97},
	{x=671,y=223,w=65,h=289},
},ENDCOLLS.

entities = {
	{x=184,y=551,w=32,h=48,id=5},
},ENDENTITY.

events = {
	{typ=1,x=7,y=21,room=2,goX=9,goY=3},
	{typ=1,x=8,y=21,room=2,goX=9,goY=3},
},ENDEVENTS.

TILESET = 1 ,ENDTILESET.